{}	全部显示
{TEXT}	文本
{CAMERA}	相机
{ITEM}	道具
{BG}	背景图像
{MUSIC}	音乐
{WAKU}	框架
{LOADUNIT}	人物配置
{UNITMOVE}	单位运动
{UNITREMOVE}	单位擦除
{UNITPERSOLNAL}	单位人事
{UNIT}	其他单位
{WEATHER}	天气
{MAPCHANGE}	地图変化
{MAPEFFECT}	地图制作
{MAP}	地图其他
{BATTLE}	地图战斗
{SUBROUTINE}	子程序
{COND}	条件
{JUMP}	一个分支
{FLAG}	旗
{WMAPMOVE}	世界地图移动
{WMAPTEXT}	世界地图文本
{WMAPUNIT}	世界地图单位
{WMAP}	世界地图其他
{ENDING}	结束关系
