//特性1
01=Weapon	Sets item as a weapon.
02=Magic	Sets item as magic.\r\nBoth Weapon and Magic must be set for magic weapons like Tomes.\r\nAdjusts damage formula to:\r\nPower-Res:Damage
03=Staff	Sets item as a staff.
04=Unbreakable	Gives an item infinite uses.
05=Unsellable	Prevents an item from being sold.
06=Brave Effect	Attacks are followed up with a second attack.\r\nBy default, this is used by Brave Weapons.
07=Magic Damage	Adjusts damage formula to:\r\nPower-Res:Damage\r\nNo weapon exp will be granted.\r\nBy default, this is used for magic swords like the Light Brand and Runesword.
08=Uncounterable	Prevents foe from counterattacking.\r\nBy default, this is used by long-range weapons like Ballistae and Bolting.
//特性2
11=Reaver Effect	Reverses the Weapon triangle.\r\nBy default, this is used by the Reaver weapons.
12=Disable Hammerne	Disables Hammerne staff from being used on item.
13=Monster Lock	Restricts item use to only those with the Monster Lock set.\r\nBy default, this is set for dragonstones, claws, talons, etc. Not set for Mogall Spells.
14=Weapon Lock 1	Restricts item use to only those with the Weapon Lock 1 set.\r\nBy default, this is unused. Use for custom unique weapons.
15=Myrmidon/Swordmaster Lock	Restricts item use to only those with the Myrmidon/Swordmaster lock set.\r\nBy default, this is set for Shamshir.
16=Hide Weapon Info	Hides all weapon info except for the Prf mark.
17=Negate Flying Effectiveness	When equipped, negates Bow effectiveness against Flying units.\r\nBy default, this is set for the Fili Shield.
18=Negate Criticals	When equipped, prevents enemy critical hits.\r\nBy default, this is set for the Hoplon Guard.
//特性3
21=Unusable	??. By default, this is unused.
22=Negate Defenses	Weapon ignores the opponent's defense/resistance stat.\r\nBy default, this is set for Luna.
23=Eirika Lock	Restricts item use to only those with the Eirika Lock set.\r\nBy default, this is set for Rapier and Sieglinde.
24=Ephraim Lock	Restricts item use to only those with the Ephraim Lock set.\r\nBy default, this is set for Reginleif and Siegmund.
25=Lyn Lock	Restricts item use to only those with the Lyn Lock set.\r\nBy default, this is unused. Use for custom unique weapons.
26=Athos Lock	Restricts item use to only those with the Athos Lock set.\r\nBy default, this is unused. Use for custom unique weapons.
27=??	???
28=??	???
//特性4
31=??	Can be patched with Shield Patch@original.
32=??	Can be patched with Shield Patch@aera.
33=??	Can be patched with Amulet Patch.
34=??
35=??
36=??
37=??
38=??
