01=Physik	Registriere dich als Waffe, die ausgerüstet werden kann.
02=Magie	Registriere dich als Gegenstand, um einen magischen Angriff auszuführen.\r\nMacht (magische Kraft) - Magie = Schaden.
03=Mitarbeiter	Registrieren Sie sich als Zauberstab.
04=Ausdauer Ausdauer	Wir werden es unbegrenzt verfügbar machen
05=Special (kann nicht verkauft werden)	Es wird zu einem besonderen Gegenstand, der nicht im Laden verkauft werden kann.
06=Zweimal angreifen	Du wirst zweimal angreifen können.\r\nEs wird in Waffen der mutigen Serie in FE verwendet.
07=Magisches Schwert	Registriere dich als magisches Schwert.\r\nMacht (magische Kraft) - Magie = Schaden.\r\nAußerdem fügt das magische Schwert keine Waffenfähigkeiten hinzu.
08=Beide Seiten können nicht kontern	Beide Seiten können nicht zurückschlagen oder verfolgen.\r\nEs wird als Fernkampfwaffe in FE verwendet.
11=Attributumkehrung	Ich werde die Süße umkehren.\r\nEs wird mit Gegenständen wie Schwertkiller verwendet.
12=Unreparierbar	Haman wird nicht in der Lage sein zu reparieren
13=Dämonen exklusive Waffe	Registriere dich als exklusive Dämonenwaffe.\r\nWenn es vom Spieler benutzt wird, wird es zu einem Bug-Item, das jeder mit dem Dark-Attribut ausstatten kann.
14=Spezialwaffe 1 (unbenutzt)	Es ist eine spezielle Waffe, die nur Charaktere benutzen kann, die eine Gruppe exklusiver Waffen 1 besitzen.\r\nDa es in FE 8 nicht verwendet wird, verwenden wir es für Ihren Umbau.
15=Schwertkämpfer / Schwertmeister	Schwertkämpfer / Sodomas Es ist eine Spezialwaffe, dass nur Charaktere benutzt werden können, die eine Gruppe exklusiver Waffen besitzen.\r\nIn FE 8 können Scheindichtungen ausgerüstet werden.
16=Nur für exklusive Marke	Nur ★ Marke der exklusiven Waffe wird angezeigt.
17=Flug Spezialeffekt ungültig	Es wird keinen fliegenden Spezialeffekt erhalten.\r\nIn FE 8 wird es als Wächter von Feir verwendet.
18=Todesbrand	Es wird keinen Todesstoß erhalten.\r\nIn FE 8 wird es als Wächter von Hopron verwendet werden.
21=Nicht verfügbar	???
22=Verteidigung ignoriert	Du kannst die Verteidigung des Gegners ignorieren und sie beschädigen.\r\nEs ist in Luna in FE 8 verwendet.
23=Eliq exklusive Waffe	Es ist eine spezielle Waffe, dass nur Charaktere verwendet werden können, die eine Gruppe von exklusiven Wehren besitzen.\r\nIn FE 8 wird es in Rapier und Sigelinde verwendet.
24=Ephram exklusive Waffe	Es ist eine spezielle Waffe, die nur Charaktere benutzen kann, die eine Waffengruppe für Ephram besitzen.\r\nIn FE 8 wird es in Leggings und Sigmund verwendet.
25=Waffen ausschließlich für Lynn (unbenutzt)	Es ist eine spezielle Waffe, die nur Charaktere benutzen kann, die eine Gruppe von Waffen exklusiv für Lynn haben.\r\nDa es in FE 8 nicht verwendet wird, verwenden wir es für Ihren Umbau.
26=Athos exklusive Waffe (unbenutzt)	Es ist eine spezielle Waffe, die nur von Charakteren benutzt werden kann, die eine Gruppe von Athos exklusiven Waffen halten.\r\nDa es in FE 8 nicht verwendet wird, verwenden wir es für Ihren Umbau.
27=??
28=??
31=??	Es ist für den Schild-Patch @ Original reserviert.
32=??	Es ist mit shield patch @ aera reserviert.
33=??	Es ist mit einem Amulett-Patch reserviert.
34=??
35=??
36=??
37=??
38=??
